room_id|facility_id
23     |2
21     |4
10     |1
28     |3
26     |2
21     |1
18     |3
13     |4
18     |4
9      |4
2      |3
7      |4
20     |3
22     |2
20     |2
27     |3
6      |2
4      |3
26     |4
13     |2
